Ababuo  	Kind, das zurück kommt  	Ewe
Abadet 	Tröster 	Eritrea
Abagbe 	wir beteten für dieses 	Nigeria, Yoruba
Abam 	das 2. Kind nach Zwillingen 	Twi
Abayomi 	freundliches Zusammentreffen 	Nigeria, Yoruba
ABBA 	geboren am Donnerstag 	Ghana; Fante
ABBO 	viel Glück 	Mudama
ABEBA 	Blume 	Äthiopien
Abebi 	wir fragten nach ihr 	Nigeria, Yoruba
Abeje 	wir fragten für dieses 	Nigeria, Yoruba
ABENA 	geboren am Dienstag 	Ghana, Akan
Abeo 	ihr Geburtstag bringt Freude 	Nigeria, Yoruba
Abiba 	ein Kind, was später geboren wurde, als die Großmutter starb 	Yoruba,Nigeria
Abidemi 	geboren ohne Vater 	Nigeria, Yoruba
Abikanile 	höret 	Nigeria, Yoruba
Abimbola 	reich geboren 	Nigeria, Yoruba
Abiona 	geboren am Wegesrand (die Mutter war auf einer Reise, als das Kind geboren wurde) 	Nigeria,Yoruba
Abla 	Wilde Rose 	Swahili
Abnet 	Vorbild 	Eritrea
Abuya 	geboren, als der Garten blühte 	Luo
Acai (ashai) 	die Schüchterne 	Sudan
Achieng 	Mittags geboren 	Luo

Adanna
	Vaters geliebte Tochter 	 
Ada 	die Erstgeborene 	Nigeria
Ade 	Krone,königlich 	Nigeria,Yoruba
Adebanke 	Gott gibt auf sie acht 	Nigeria,Yoruba
Adebola 	sie ist ehrbar 	Nigeria, Yoruba
Adebumi   (Ah-day-boo-me) 	Reichtum ist gekommen 	Nigeria
Adedagbo 	Freude ist eine Krone 	Nigeria, Yoruba
Adedewe 	die Krone ist zersplittert 	Nigeria, Yoruba
Adekofoworola 	Krone, die man nicht mit Geld bezahlen kann 	Yoruba
Adeleke 	die Krone bringt Freude 	Nigeria, Yoruba
Adenike (ah-deh-nee-kay) 	Krone, sie ist liebevoll 	Nigeria,Yoruba
Adeoga (ade-ogo) 	die Krone der Herrlichkeit 	Nigeria,Yoruba
ADEOLA 	die Krone der Ehre 	Nigeria,Yoruba
Adesimbo 	nobel geboren 	Nigeria, Yoruba
Adetokumbo (ah-Deh-toh-koom-boh) 	sie kam über das Meer 	Nigeria, Yoruba
ADETOUN 	Prinzessin 	Nigeria,Yoruba
Adhiambo 	geboren am Abend nach Sonnenuntergang 	Kenia,Luo
Adhra 	Entschuldigung 	Swahili
Adia 	ein Geschenk 	Hausa
ADJOA (Ah-joh-ah) 	geboren am Montag 	Ghana
Adila 	gerade heraus 	Swahili
Adimu 	selten 	Swahili
Adin 	wunderschön 	Swahili
Adita 	Name eines Korbes mit hohen Seiten 	Luo,Kenia
Adla 	das gesetz 	Swahili
Adongo 	zweite von den Zwillingen 	Luo
ADOWA (ah-doo-wah) 	edel, grossartig 	 
Adowa 	Dienstag geboren 	Akan
Aduke 	sehr geliebt 	Nigeria, Yoruba
Adumadan 	dunkelhäutig und sehr schön 	Nigeria,Yoruba
Adwoa (ah-doo-wa) 	Frieden 	Ghana
Adwoa 	Montag geboren 	Fante
Afaafa 	Ehre 	Swahili
AFIA (EFFIA) 	geboren am Freitag 	Ghana
Afifa 	rein mit Ehre 	Swahili
AFYA (Ahf-yah) 	Gesundheit 	Kiswahili
Afishetu 	jung und heldenhaft 	 
Afryea 	geboren in guten Zeiten 	Ewe
AFUA (A-fu-a) 	geboren am Freitag 	Ewe
Aguidi (a-gi-bi) 	sich wohl fühlen 	Ghana,Ewe
Ahadi 	mit viel Versprechen 	Swahili
Ahorisha 	immer gewollt, so geschehen ( N. gegeben, nach vielen Jahren der Kinderlosigkeit) 	Rwanda,Kinyarwanda
Aida 	Gewinn 	Swahili
Aina (eye-nah) 	ein Mädchen, dass mit der Nabelschnur, die sich um den Hals gewickelt hatte, geboren wurde 	Nigeria, Yoruba
Ainka (A-ink-kay) 	die einzige Hoffnung 	Tonga
Aini-Alem 	Auge der Welt 	Eritrea,Äthiopien, Tigrinya
Ainra 	immerwährende Kraft 	Swahili
Aisha ( I-ee-sha) 	sie lebt 	Swahili
Aiyetero 	Friede auf Erden 	Nigeria, Yoruba
Aja (Ah-ja) 	Hohe Priesterin von Mecca 	 
Ajia 	schnell 	Swahili
Akanke 	sie zu treffen ist sie zu lieben 	Nigeria, Yoruba
Akech 	geboren während einer Hungersnot 	Kenia, Luo
Akello 	geboren nach Zwillingen 	Luo
Akeyo 	geboren während der Ernte 	Luo
Akilah 	intelligent, vernünftig 	Swahili
Akinyi 	geboren früh am Morgen 	Luo
Akippi 	Wasser 	Toposa, Südsudan
Akoko 	Boogie man oder Monster ( gruselige Gestalt aus der Kindheit) 	Kenia,Luo
Akosua 	geboren am Sonntag 	Ghana,Ashanti
Akua (Ah-quee-yah) 	geboren am Mittwoch 	Ghana
Akuyi 	ein Kind, dass geboren wurde, als ein anderes Kind starb ( Wiedergeburt) 	Nigeria, Yoruba
Akwe 	die Friedvolle 	Kenia,Luo
Alake 	eine die verwöhnt wird 	Nigeria, Yoruba
Alemash 	mache es grün 	Eritrea,Äthiopien,Tigrinya
Alima 	milde, menschlich 	Nigeria
Almasi 	Diamant 	Swahili
Almaz 	Diamant 	Äthiopien, Eritrea
Amachi (Ah-mah-chi) 	der weiss, dass Gott uns das Kind gebracht und in einen Trog gelegt hat 	Nigeria,Ibo
Amadika 	wird geliebt 	Zimabwe, Mashona
Amali 	Hoffnung 	Swahili
Aman 	vertrauenswürdig 	Somalia
Amana 	Vertrauen 	Swahili
AMARA (Ah-mah-rah) 	  	Nigeria,Ibo
Amaziah 	sie ist sehr speziell 	Swahili
Amina 	vetrauenswürdig 	Swahili
AMINIA 	zu glauben 	Kiswahili
AMINATA 	  	Senegal
Amma 	geboren am Samstag 	Ghana,Ashanti
Amne 	Sicherheit 	Swahili
Amoke 	Liebling 	Nigeria,Yoruba
Ana 	wo 	Westafrika, Wolof
Anana 	sanft, wohlerzogen 	Kiswahili
Ananda 	Glück, Seeligkeit 	Mauritius, indisch, Sanskrit
ANAYA (Ah-ny-ah) 	schau zu Gott 	Nigeria,Ibo
Aneesa 	Freund, Kompanion 	Swahili
Anele (A-ne-le) 	Genug. ( die Eltern geben diesen Namen dem Letztgeborenen, niemals dem Erst-oder Zweitgeborenen) 	Südafrika,Xhosa
Angavu 	sie scheint 	Swahili
Anisa 	freundlich 	Swahili
Anyango (Oh-yan-go) 	Freund 	Kenia,Af
ANULIKA (Ah-new-li-kah) 	Glück ist das Schönste 	Nigeria,Ibo
Anukis 	Mädchen mit federleichtem Kopfputz 	Ägypten
Anyawu 	eine, die so schön ist, wie der Sonnenaufgang oder der Sonnenuntergang 	Nigeria, Igbo
Aoko 	außerhalb, die Mutter hat das Krankenhaus nicht rechtzeitig erreicht 	Kenia, Luo
Aola 	"falscher Hund" 	Luo-Abasuba, Kenia
Apeke 	Liebling 	Yoruba
Apinke 	sie ist jedermanns Liebling 	Yoruba
Aponbepore 	eine, die schöner ist wie das beste Palmöl 	Yoruba
Arawet 	Mond 	Kenia, Kalenjin
Areta 	ein Charmeur 	Bini
ARMANI (R-mah-nee) 	Glaube 	Nigeria,Imani
ASABI (Ah-sa-bi) 	Eine, der Auserwählten 	Nigeria,Yoruba
Asali 	süßer Honig 	Swahili
Asatira 	Legende, Sage 	Swahili
Asha 	Leben 	Kiswahili
Ashanti 	große, kräftige Frau 	Ghana
ASHAKI 	schön 	Westafrika
Ashietu 	Trost 	Nigeria
Asli 	original, pur 	Tigrinya, Äthiopien, Eritrea
ASSAGGI (as-sa-guy) 	groß, kräftig 	Simbabwe
Aster 	Stern 	Äthiopien, Eritrea
Atiti 	Namen weiblicher Babys für die ersten 3 Monate bis ein permanenter Name gefunden ist 	Edo, Nigeria
Atonga 	Name eines Korbes mit hohen Seiten 	Kenia, Luo
Audi 	die letzte Tochter (wird einem Mädchen gegeben, was nach dem Tod des Vaters geboren wird) 	Westafrika, Hausa
Awero 	eine, die sich wäscht und gut kleidet 	Yoruba, Nigeria
Awiti 	sie wurde fortgeschickt 	Kenia, Luo
AYAN 	heiter, froh, aufgeweckt 	Somalia
AYANA 	schöne Blume 	Äthiopien
Ayashe 	weggeworfen 	Hausa, Westafrika
AYO (Ah-yo) 	Freude 	Nigeria,Yoruba
Ayodele 	Freude kommt ins Haus 	Yoruba, Nigeria
Ayoka 	Eine, die überall Fr Freude hinbringt 	Yoruba, Nigeria
Ayomide (ah-your-me-day) 	meine Freude ist angekommen 	Nigeria,Yoruba
Ayondela 	ein kleiner Baum biegt und krümmt sich, wir alle biegen uns in Richtung des Todes 	Ovimbundu, Angola
AZA 	Kraft 	Swahili
Azana 	vollendet, perfekt 	Südafrika
AZINZA 	Meerjungfrau 	Togo
AZIZA 	kostbar, herrlich,prächtig 	Kiswahili,Somali
AZMERA 	Ernte 	Äthiopien
Azuka 	größte Unterstützung -
Baba  	geboren am Donnerstag  	Fante
Baderinwa 	des Respektes würdig 	Yoruba
Badriya 	schön wie das Meer 	Swahili
Badu  	kraftvoll 	 
Baderinwa 	respektvoll 	 
Bahati  	mein Glück ist gut 	Kiswahili
Bahatisha 	glaube, eine Chance zu bekommen 	Kiswahili
Bahiyah (Bye-he-yah) 	schön 	Swahili
Baina  	sprudelnd 	 
Bakundukize 	sie mögen den Reichtum 	Kinyarwanda, Ruanda
Bamporiki 	warum verraten sie mich? 	Kinyarwanda, Ruanda
Baramousso 	die Gepflegte, favourit 	Bambara, Westafrika
Barayagwiza 	sie haben viel zu sagen 	Kinyarwanda, Ruanda
Barke 	Segen  	Swahili
Barongo 	Jüngere der Zwillinge 	Kisii
Basha 	Gottes Akt 	Swahili
Basham 	reich 	Swahili
Bashasha 	Lächeln 	Kiswahili
Bashira 	die gute Nachrichten bringt 	Swahili
Basma 	ein Lächeln 	Swahili
Bast 	ägyptische Gottheit 	Ägypten
Baturiya 	hellhäutig 	Hausa, Nigeria
Batuuli 	Jungfrau 	Swahili
Baya 	nicht schön 	Swahili
Bayavuge 	Lass sie sagen, was sie wollen 	Kinyarwanda, Ruanda
Bayina 	Beweis 	Swahili
Bayo  	die Freude gefunden 	 
Bebi 	Baby 	Swahili
Becca  	Prophet 	Yoruba
Belaynesh 	Du bist über allem, Du bist die Beste 	Eritrea, Äthiopien
Besede 	geboren am Sonntag 	 
Besma 	Lächeln 	Nordafrika
Bejide  	das Kind wurde in der Regenzeit geboren 	 
Beyla 	bei Gott 	arabisch
Bhekisisa 	 sei vorsichtig,achtsam 	Südafrika,Zulu
Bia 	zuhause, daheim 	Swahili
Bikilu 	hoch gewachsen oder groß 	Äthiopien
Bikita 	Ameisenbär 	Zimbabwe
Bilen 	die Pupille eines Auges 	Tigrinya, Äthiopien, Eritrea
Bilki 	Schwur 	Nigeria
Bimkubwa  	große Lady 	 
Binta 	mit Gott 	Westafrika
Binah  	eine Tänzerin 	 
Bintu (Bean-too) 	die Schöne 	Elfenbeinküste,Senegal
Bisa 	sehr geliebt 	 
Bissirat 	Glückwünsche, gute Neuigkeiten 	Tigrinya, Äthiopien, Eritrea
Boahinmaa  	eine, die ihre Gemeinde verliess 	 
Bosede 	geboren am Sonntag, sehr hübsch, ordentlich 	Yoruba, Nigeria
Bukene 	Armut 	Tigrinya, Äthiopien, Eritrea
Bukoko 	Bier ( Mutter trank während der Schwangerschaft gern Bier) 	Tonga, Zambia
Bukola (Bu-cua-la) 	sie wird Reichtum erreichen 	Nigeria,Yoruba
Bunmi  	mein Geschenk 	 
Bunze 	unreife Frucht 	Bakongo, Westafrika
Busara  	Weisheit 	
o. unser vergangener Ruhm
	Nigeria, Igbo

Caimile  	Name gegeben, nachdem alle Kinder gestorben sind  	Ovimbundu, Angola
Capopia 	Gott sagte, ich streite nicht 	Ovimbundu, Angola
Ceyavali 	es kommt wieder 	Ovimbundu, Angola
Chalondra 	klug, geschickt 	 
Chaltuu 	das erstgeborene Mädchen 	Oromo-Kush
Chandamukulu 	Mutter der Könige von Bemba 	Zambia
CHANYA 	  	Kenia
CHANGA 	vorherrschend sein 	 
Chanecia 	geschickt und schön  	 
CHARA 	  	Äthiopien (Südwest)
Chaonaine 	sie hat mich gesehen 	Yoruba
Chausiku 	nachts geboren 	Swahili
Cheche 	kleines Ding, kleines Teil 	Swahili
Chiaka 	Gott hat gesagt 	Nigeria,Ibo
CHIDIMA (Chi-dee-mah 	Gott ist gut und wundervoll 	Nigeria,Ibo
Chideria 	was Gott geschrieben hat 	Nigeria
CHIKU 	Erzähler 	Swahili
Chilala 	schlafend 	Tonga, Zambia
Chililabombwe 	quakender Frosch 	Zambia
Chimpati 	Rinderweide 	Tonga, Zambia
Chimwala 	Stein 	Yao
CHINARA 	von Gott empfangen 	Nigeria,Ibo
Chinaza 	Gottes Antworten 	Igbo, Nigeria
Chinue 	mit Gottes Segen 	Ibo
CHIOMA (Chi-uh-mah) 	wundervoller Gott 	 
CHINAKA 	Gott hat entschieden 	Nigeria
Chinelo (Chi-ne-elo) 	Gott denkt an dich 	Nigeria,Ibo
Chinyere (Shin-yair-ree) 	Geschenk Gottes 	Nigeria,Ibo
CHINUE 	gesegnet sein 	 
CHIMWALA  	Stein 	 
Chipei 	geben 	Nigeria
Chipo 	Geschenk 	Shona
Chitanga 	Kürbis 	Tonga, Zambia
Chotsani 	nimm mich mit 	Yao
Chuki 	geboren als Fremder 	 
Cilanga 	Trockenheit 	Tonga, Zambia
Cilingohenda 	es ist schade 	Ovimbundu, Angola
Cilombo 	Sehen schmerzender Augen 	Ovimbundu, Angola
Cinakavali 	die Arbeit muss zu Ende gemacht werden, um Nutzen zu haben 	Ovimbundu, Angola
Cisanganda 	der, der die Arbeit macht, bekommt das Geld 	Ovimbundu, Angola
Cisengu 	kleiner Vogel mit langem Schwanz 	Ovimbundu, Angola
CLEOPATRA 	schwarze Königin 	Ägypten
Cokovenda 	ein Ding, was in den Laden gehört 	Ovimbundu, Angola
Dabiku  	Gabe  	Swahili
DADA 	Schwester 	Kiswahili
DADA 	Mädchen mit lockigem Haar 	Yoruba
Dacia (day-sha) 	Purpurfarbene Blume 	 
Dafina (Dah-fee-nah) 	Geschenk,Schatz,Reichtum 	Swahili
DALILA 	sanft ist ihre Seele 	Shona
Dalji 	sie hat einen wundervollen Gang 	Swahili
Damisi 	freudig, froh 	Swahili
Damtien 	sie ist gesegnet 	Elfenbeinküste, Moba
DANUWA 	eine enge Freundin 	Hausa
DARA 	schön 	Bermuda
Darratu 	eine blühende Blume 	Äthiopien
Daurama 	9. in der Thronfolge 	Hausa
Dawa 	von der Mitte 	Swahili
DAYO 	die Freude ist angekommen 	Nigeria,Yoruba
DEKA 	eine, die gebeten hat 	Somalia
Dekat 	Geschichten 	Bari, Südsudan
Dene 	Wasserlilie 	Swahili
Denhere 	Dickicht 	Mashona, Zimbabwe
Dericia (Dah-ree-sha) 	athletisch 	afro-amerikanisch
Dhakiya 	intelligent 	Swahili
Dhambizao 	Sünde ist nicht mein 	Swahili
Dhuriya 	Nachfahre 	Swahili
Dikeledi 	Tränen 	Tswana
Diketi 	klein 	Oromo, Äthiopien, Kenia
Dina 	ein schöner schützender Platz 	Mashona, Zimbabwe
Djibola 	öffnen 	Zaire
DJIDADE 	sie ist erwünscht 	 
DO 	das erste Kind nach Zwillingen 	 
Dodo 	lieblich, groß und rund 	Swahili
DOFI 	das zweite Kind nach Zwillingen 	 
Dolapo 	Glückseligkeit 	Nigeria,Yoruba
Doli 	Puppe 	Swahili
DOTO 	das jüngere Kind der Zwillinge 	 
Dupe 	danke 	Nigeria,Yoruba
DUT 	Trost 	Sudan,Dinka
DZIKO 	die Welt 	
EBIERE  	   	Niger,Ijaw
EFFIWAT 	  	Nigeria
Ebun 	Geschenk 	Yoruba
EFIA 	geboren am Freitag 	Ghana,Fante
Efunsetan 	Efun( Gottheit) hat es gemacht 	Yoruba, Nigeria
Ehobib 	fand es wunderschön 	Khoi, Südafrika
Eidi 	Festival 	Swahili
Ekuva 	Abkömmling einer göttlichen Linie 	Ovimbundu, Angola
Elon (ee-lon) 	Gott liebt mich 	 
Elumbu 	mysteriös, Frühchen, welches sehr geringe Überlebenschancen hatte 	Ovimbundu, Angola
Emefa (Eh-meh-fa) 	hier ist Frieden 	Ghana,Ewe
Emojung 	der/das Alte 	Karamojong
Eno (anu) 	Geschenk 	Nigeria,Efik
Enomwoyi 	die Charme und Grazie hat 	Benin
Enyonyam 	es ist gut für mich 	Ewe
Erin 	Elefant 	Yoruba, Nigeria
Erinle 	Name einer nigerianischen Gottheit 	Yoruba, Nigeria
Esenje 	so gehen die Dinge oder thats life 	Ovimbundu, Angola
ESHE 	Leben 	Swahili
ESI 	geboren am Sonntag 	Ghana, Ewe und Fante
ESIANKIKI 	junges Mädchen 	Kenia,Massai
ESINAM 	Gott hört mich 	Ghana,Ewe
Etana 	die Starke 	Swahili
Etuhole (Etu-ho-le) 	Gott liebt uns 	Ghana,Oshiwambo
Ezenma 	Königin der Schönheit 	Igbo, Nigeria


Fabayo  	glückliche Geburt ist Freude  	Yoruba
Fabunni 	Ifa (Gottheit) gab mir es 	Yoruba, Nigeria
Fadhila 	aussergewöhnlich 	Swahili
Fadhili 	Gutmütigkeit, guter Wille 	Swahili
Fadhiya 	Heiland, Erlöser 	Swahili
Fahari 	Ausgeber 	Swahili
Fahima 	versteht, hat gelernt 	Swahili
Faida 	Gewinner 	Swahili
Fakhta 	löchern 	Swahili
Faizah (fah-ee-zah) 	ihr Ich ist siegreich 	Swahili
Falala  	geboren im Überfluss 	 
Fanaka 	Wohlstand 	Swahili
Fanikia 	Wohlstand 	Swahili
FARA 	  	Kiswahili
Faraa 	die Fröhliche 	Hausa
Farai  (Far-a-yi) 	glücklich sein 	Simbabwe,Shona
Farafenni 	der Zipfel eines Reisfeldes 	Gambia, Mandingo
Farashuu 	Schmetterling 	Swahili
Faraya 	Erlösung 	Swahili
Farida 	Unikat 	Swahili
Farih 	fair und hell 	Hausa
Farisa  	sie macht glücklich 	 
Farisi 	kompetent 	Swahili
Fatimetu 	entwöhnt 	Nigeria
Fauziya 	glorreich, erfolgreich 	Swahili
FAYOLA 	Glück geht mit Reichtum einher 	Nigeria,Yoruba
Feimata  	liebe mich 	Sierra Leone
Feyikemi (Fay-yi-kay-me) 	gesegnet mit.. 	Nigeria, Yoruba
Folasade 	der Krone verleiht die Ehre 	Nigeria, Yoruba
Folayan 	in Würde gehen,laufen 	 
Foluke (Fo-loo-care) 	in Gottes Obhut gegeben 	Nigeria,Yoruba
Freweynee 	Kern einer Weintraube 	Tigrinya, Eritrea, Äthiopien
Fujo 	geboren nach einem Streit 	 
Fumane 	die Gefundene 	Basotho, Lesotho
Funmilayo 	sie hat mir Glück gegeben 	Nigeria,Yoruba
Furaha 	Freude, Glück 	Swahili
Gakee  	eine, die sehr gut Hirse für Porridge zerstoßen und mahlen kann  	Meru, Kenia
Gasira 	mutig 	Swahili
Gathoni 	sie ist eine Gefangene 	Kikuyu
Genet 	Garten Eden 	Eritrea, Äthiopien
Ghalyela 	teuer, kostbar 	Swahili
Ghanima 	gutes Glück 	Swahili
Gharibu 	Fremder, Besucher 	Swahili
Gheche 	kleines Ding 	Swahili
Ghiday 	mein Anteil, mein Dienst 	Tigrinya, Eritrea, Äthiopien
Ginikanwa 	was ist schöner als ein Kind? 	Igbo, Nigeria
Gimbya  	Prinzessin 	Swahili
Ghipe 	junge Pflanze 	Swahili
Gina  	eine kraftvolle Mutter der schwarzen Menschen 	Namibia
Goitsemedime  	nur Gott weiß 	Swahili
Gzifa 	ein Teil von... 	Ghana,Eww

Haazita  	Feinde wollen uns angreifen  	Tonga, Zambia
Habeebah 	die Liebste 	Swahili
Haben (Ha-Ben) 	Courage 	Eritrea
Habiba 	geliebt 	Swahili
Habibuna 	unser Geliebtes 	Swahili
Hada 	salziger Ort 	Kenia
Haddas 	neu 	Tigrinya, Eritrea, Äthiopien
Hadih 	Respekt, ehrbar 	Swahili
Hadiketi 	neu 	Tigrinya, Eritrea, Äthiopien
HADIYA 	Geschenk 	Swahili
Hafidha 	gedankenstark 	Swahili
Hafsa 	Klang, Urteil 	Swahili
Hagodana 	das Kind wurde geboren, als die Familie einwanderte 	Oromo, Äthiopien, Kenia
Hagosa 	Glück, Freude 	Tigrinya, Eritrea, Äthiopien
Haiba 	charmant 	Swahili
Hajanika 	verfügbar sein, zur Hand sein 	Tonga, Zambia
Hajari 	Flug 	Swahili
Hajunza 	morgen 	Tonga, Zambia
Hakika 	Wahrheit 	Swahili
Hakima 	sensibel 	Swahili
Hakunyo 	Bauchnabel 	Oromo, Äthiopien, Kenia
Hala 	glorreich 	Swahili
Halili 	die Liebste 	Swahili
HALIMA 	Sanfte, 	Swahili
Hamida 	die Schenkende 	Swahili
Hanaa 	Freude, Glück 	Swahili
Hanazullumi 	das Böse verhindern 	Hausa
Hanetu 	Anmut, Grazie 	 
Hanifa 	Reinheit in Person 	Swahili
HANNA 	Glücklich sein 	Hausa
Hanuni 	freudig, froh 	Swahili
Haracha 	Frosch 	Oromo, Kenia, Äthiopien
Hareena 	wir haben ausgewählt 	Tigrinya, Eritrea, Äthiopien
HASANA 	die Erstgeborene von Zwillingen 	Westafrika
HASANATI 	Glück 	 
Hashoba 	jemand der sehr hübsch oder schick ist 	Oromo, Kenia, Äthiopien
HASINA 	Gott 	Swahili
Hasweeka 	verloren gehen, sich verirren 	Tonga, Zambia
Hatshepsut 	Ägyptische Königin 	Ägypten
HAWA 	Sehnsucht 	Kiswahili
Hawakulu 	Urmutter, Leben 	Nigeria
HAZIKA 	intelligent 	Hausa
Hazina 	Jagd 	Kiswahili
Heewan 	Urmutter, leben 	Eritrea, Äthiopien
HELINA 	bewusst 	Äthiopien
HEMBADOON 	Sieger 	 
Hija 	vom arab. hajj= Pilgerreise nach Mekka während des Ramadan 	 
Hiwot 	Leben 	Tigrinya, Eritrea, Äthiopien
HOLA 	Retter, Heiland 	Ghana,Ewe
HOMA 	Fieber 	Kiswahili
HOVA 	mittlere Klasse 	Madagascar,Betsiloa
Husna 	die Schönste 	Swahili
Huso 	die Traurigkeit einer Braut 	Ovimbundu, Angola
Hypatia 	schöne ägypt. Philosophin, zu Tode gesteinigt 	Ägypten

Ibtisam  	Lächeln  	Swahili
Idihi 	energievoll 	Swahili
Idowu 	erstgeborenes nach Zwillingen 	Yoruba
Ifama 	alles ist gut 	Ibo
Ife 	Liebe 	Yoruba
Ifetayo 	Liebe bringt Glück 	Yoruba
Iffat 	tugendhaft 	Swahili
Igbekoyi 	sogar der Busch darf es nicht haben ( das Kind soll überleben) 	Yoruba, Nigeria
Ige 	geboren mit dem Fuß zuerst 	Yoruba
Ijaba 	ein Wunsch wurde erfüllt 	Hausa
Ikoko 	kleiner Fisch 	Lingala, Zaire
Ikuseghan 	Friede überlebt Krieg 	Benin
Ilega 	während der Jagdsaison geboren 	Didinga, Südsudan
Ilori 	schwanger geworden während der Menstruation 	Yoruba, Nigeria
Illham 	Inspiration 	Swahili
Ima (ee-ma) 	Liebe, Nächstenliebe 	Nigeria,Efik
Iman 	Glaube, Vertrauen 	Somalia
Imani 	Glaube, Vertrauen 	Kiswahili
Imara 	fester Wille 	Swahili
Ina 	Mutter des Regens 	Hausa
Inaya 	Vorsehung 	Swahili
Isabis 	schön anzusehen 	San, Südafrika
Isoke  (ah-sung-key) 	ein wundervolles Geschenk von Gott 	Nigeria
Iruwa ( E-ru-wa) 	eine, die die Welt gesehen hat 	Nigeria,Ibo
Iyabode 	Mutter kommt zurück 	Yoruba, Nigeria
Iyakaremye 	nur der Erschaffende hat Macht über mich 	Kinyarwanda, Ruanda
Izegbe 	ein lang erwartetes Kind 	 
Izibili 	sehr dunkles Kind 	Ishan, Nigeria
JAHA  	Würde, hohe Stellung  	Swahili
Jahi 	Prominenz 	Swahili
Jahia 	prominent 	Swahili
Jahzara (jah - ZAH - rah) 	gesegnete Prinzessin 	Äthiopien
JAINEBA 	  	Senegal
JAla (Jay-la) 	Der Einzigartige 	afro-american
Jali 	Respekt, ehrbar 	Swahili
JALIA 	Erfüllung 	Kiswahili
Jamala 	freundlich, gute Manieren 	Swahili
JAMILA 	schön, elegant 	Somalia,Swahili
Jana 	gesundes Kind 	Swahili
Janna 	der Himmel 	Swahili
JANI 	ein Blatt 	Kiswahili
Japera 	wir sind fertig 	Swahili
Jasira 	mutig 	Swahili
Jata 	Stern 	Kikuyu
Jauhar 	Juwel 	Swahili
JENDAYI 	Danke 	Shona
Jina 	Name, Identität 	Swahili
Jinaki 	selbstsicher, stolz 	Swahili
Jioni 	abends 	Swahili
Jirani 	Nachbar 	Swahili
Johanna 	Gottes Segen 	Swahili
JOHARI 	Juwel 	Kiswahili
JUBA 	geboren am Montag 	Ghana,Ashanti
JUMAPILI 	geboren am Samstag 	
Kabisa  	für immer  	Swahili
Kadija 	Frau des Propheten Mohammed 	Swahili
Kagiso  	Frieden 	Botswana,Tswana
Kahfee 	Stille, Ruhe, Frieden 	Swahili
Kaimah (kama or Kay-ma) 	  	Liberia
Kainda  	Tochter des Jägers 	Kenia,Tharaka
Kajumba 	schön 	Uganda,Bantu
Kakra  	die jüngere der Zwillinge 	Ghana,Fante
Kali  	energisch, tatkräftig 	Elfenbeinküste,Senufo
Kalifa (Kah-lee-fah) 	die Helle, prächtig 	Swahili
Kamaria  	sie mag den Mond 	Swahili
Kambo  	die Unglückliche 	Simbabwe,Shano
Kamohelo (Ka-mo-he-lo) 	Willkommen 	Südafrika,Sotho
Kamilah (Ka-mi-lah) 	die Perfekte 	Swahili
Kamili  	Perfektion 	 
Kanika  	schwarzer Stoff 	Kenia,Mwera
Kanoni  	kleiner Vogel 	Ulaya
Karima 	generös 	Swahili
Karimu  	die Großzügige 	 
Karasi (Car-a-sigh) 	Leben und Weisheit 	 
Kashore 	mit Humor 	Swahili
Kayla 	die Arme 	 
Kaweria  	sie wird geliebt 	Kenia,Meru
Kefilwe  	ich wurde gegeben 	Tswana
Kehinde  	der zweitgeborene Zwilling 	 
Kenyetta 	die Unschuldige 	Südafrika
Kereeditse (ke-reh-di-tseh) 	ich höre 	Botswana,Batswana
Kesi 	in einer Zeit geboren, als es mit dem Vater Streit gab 	 
Keyah  	in guter Gesundheit 	Westafrika,Mande
Khadija  	Frau des Propheten Mohammed 	 
Khanysha (Kuh-nee-sha) 	schönes Kind 	Swahili
Khola 	Antilope, mit Grazie 	Swahili
Kianga  	Sonnenschein 	Swahili
Kibibi 	kleine Lady 	Swahili
Kiburi 	Stolz 	Swahili
Kijakazi 	dein Leben wurde uns gegeben 	 
Kimani (Key-ma-nee) 	süß und schön 	afro-american
Kinah  	eigensinnig 	 
Kissa (Kis-sha) 	die erstgeborene Tochter der Familie 	Kenia
K'Tusha 	Freude 	 
Kumani  	Schicksal 	Westafrika
Kunto 	das dritte Kind 	Ghana,Twi
Kwayera (Qua-yea-ra) 	der frühe Morgen, Morgendämmerung 	Swahili
Kya (Ky-yah) 	ein Diamant am Himmel 	 
Kukua (Ky-yah) 	geboren am Mittwoch 	Ghana
Latasha (Lah-tah'-sha  	Überraschung  	Kongo
Laini 	weich und sanft 	Swahili
Lalamika 	bete für Gnade 	Swahili
Lamia 	Glitzer 	Swahili
Latifa 	mit Sanftheit 	Swahili
Layla 	in der Nacht geboren 	Swahili
Lerato 	Liebe 	Tswana
Lekysha (lu-key-sha) 	schön, populär 	Puert Rico
Lela 	die Nacht 	Swahili
Leza 	eine, die sich durchsetzt 	Zentralafrika
Lila 	gut 	Swahili
Limber 	große Freude 	Tiv
Lina  	sanft 	Hausa
Lingaire (Ling-Air) 	eine Prinzessin des 4. Jahrtausends 	Gambia,Wolof
Lindiwe 	sie hat gewartet 	Südafrika,Xhosa
Lisha 	geheimnisvoll 	Nigeria,Hausa
Liziuzayani 	sag es jemanden 	Malawi
Lorato (Lo-ruh-toh) 	Liebe 	Botswana,Setswana
Lubaya 	junge Löwin 	Swahili
Lulu  	eine Perle 	Swahili
Lungile (Loo-ngie-le) 	die Gute 	Südafrika,Zulu
Maarifa  	profesionell  	Swahili
Machui 	wie ein Leopard 	Swahili
Madaha 	mit Grazie 	Swahili
Madiha 	würdig zu loben 	Swahili
MAFUANE  	Heimatland 	Südafrika,Bachopi
Mafunda 	Lehren 	Swahili
Mahbuba 	geliebt 	Swahili
Mahfudha 	beschützend 	Swahili
Maimuna 	gesegnet 	Swahili
MAISHA 	Leben 	Kiswahili
Makena 	glücklich 	Kikuyu
Makini 	ruhig und ausgeglichen 	Swahili
MALAIKA 	Engel 	Kiswahili
Malenga 	sie singt gut 	Swahili
MALI 	Reichtum 	Kiswahili
Malia 	Königin 	Swahili
MALKIA 	die Königin 	Kiswahili
Maluum 	speziell 	Swahili
Makeda (Ma-kee-da) 	die Schöne 	Äthiopien
MAKENA 	die Glückliche 	Kenia,Kikuyu
Mamello ( ma-me-low) 	Geduld, Ausdauer 	Lesotho
Mampezi 	Romanze 	Swahili
MANDISA 	süß 	Südafrika,Xhosa
Manga 	Wanderin 	Swahili
MARA 	Zeit 	Kiswahili
MARAHABA 	Danke 	Kiswahili
Marali (mar-ah-lee) 	Duft 	Antigua,Barbuda
Marashi 	Parfüm, Duft 	Swahili
Mardea (my-dee-a) 	die Letzte 	Ghana
MARIAMA 	ein geschenk Gottes 	Westafrika
MARJANI 	Koralle 	Swahili
Marvena (Mar-ve-nyah) 	das Kind zweier Planeten 	Anguilla
Mbhali (m'bhali) 	die Rose 	Südafrika,Zulu
MENE (Me-na) 	sie ist niemals allein 	Nigeria,Yoruba
Mesi (May-see) 	Wasser 	Asante
Meeka (Mee-ca) 	der Wille Gottes, starkes Herz, mutig 	 
Minkah (Men-kah) 	Gerechtigkeit 	Tansania
Milumbe (Me-loom-beh) 	neuer Segen, neues Glück 	Tonga
Mmaabo (mm-a-bo) 	ihre Mutter 	Botswana
MONIFA 	ich bin glücklich 	Nigeria,Yoruba
MONTSHO  	schwarz 	 
Moliehi (Mo-dee-yeh-hee) 	eine, die erwartet wurde 	Lesotho,Basotho
Mudiwa 	sie wird geliebt 	Simbabwe(Shona)
Mumbi (Mom-be) 	die erste Frau 	Kenia,Kikuyu
Mutinta (Moo-tin-ta) 	das Kind wurde geboren nach 2 oder mehr Kindern nach verbotenem Sex 	Tonga
Mwangaza 	das Licht 	Swahili
MYEISHA (My-ee-sa) 	eine, die sehr geliebt wird 	

Nabila  	nobel  	Swahili
Nabulungi 	die Wunderschöne 	Buganda
Nadhari 	Vision 	Swahili
Nadia 	die Ruferin 	Swahili
NADIFA 	geboren zwischen den Jahreszeiten 	Somalia
Nadiya 	großzügig 	Swahili
NADRA 	ungewöhnlich 	Kiswahili
Nafaika 	Wohlstand 	Swahili
Nafia 	Geschenk 	Swahili
Nafisa 	kostbares Juwel 	Swahili
Nafisika 	gut gemacht 	Swahili
NAFULA 	geboren während er Regenzeit 	Kenia,Abaluhya 
Naki 	das erste Mädchen 	Ghana, Adangbe
Nakisai (nah-ki-sigh) 	die Schöne 	Simbabwe,Shona
Naima 	graziös 	Swahili
NAJA 	Erfolg 	Somalia
Najah 	Erfolg 	Swahili
Najma 	Stern 	Swahili
Najya 	gerettet 	Swahili
Nala (Nah-lah) 	die Königin 	Tansania
Nalongo 	Mutter der Zwillinge 	Buganda
Nana 	Lady 	Swahili
NANDE (Nan-day) 	Mutter von Chaka Zulu 	Südafrika,Zulu
Nasim 	frische Luft 	Swahili
Nanyamka  (nuh-yam-kuh) 	das Geschenk Gottes 	Ghana
Na'weh 	sie hatte einen langen Weg 	Liberia
Nawiri 	ganz gesund 	Swahili
Na'Zyia 	Mutters Liebe 	Kenia
Nbulungi 	die Schöne 	Ghana
Ndapewa (Nda-pe-wa) 	sie wurde uns gegeben 	Namibia, Oshiwambo
NIA 	Entschlusskraft 	Kiswahili
NDAPEWA (nDA-pE-Waa) 	ich wurde gegeben 	Namibia,Ovambo
NDAHEPULUKA (N'da-he-pu-lu-ka)) 	ich wurde reicher 	Namibia,Ovambo
Ndidi (En-di-di) 	Geduld,Ausdauer 	Nigeria
NEHANDA 	Härte,Strenge 	Simbabwe,Zezuru
NEFERTITI 	die Schöne, die angekommen ist 	Ägypten
NGINA (Na'-gee-na) 	eine Königin 	afro-american
Ngoni (N'Go Knee)  	Gnade Gottes 	Simbabwe,Shona
NILAJA (Nee-Lah-jah) 	eine, die mit Freude gekommen ist 	Nigeria,Yoruba
NJEMILE (n-jeh-mee-lay) 	Auferstehung 	Südafrika,Xhosa
NOURBESE 	ein wunderschönes Kind 	Südafrika,Zulu
Nosine (no-see-nay) 	geboren am Donnerstag 	Benin,Nigeria
Njeri (neh - jeer - ee) 	des Kriegers Tochter 	Malawi
NKECHI (n-kay-kee) 	loyal 	 
Ntatu (Na-ta-tu) 	geboren am Mittwoch 	Nigeria,Ibo
Nneka (Nay-ka) 	Mutter ist überrascht 	Südafrika,Xhosa
Nubia (New-be-a) 	eine starke schwarze Frau dieser Nation 	Nigeria,Ibo
Nweka (nway-ka) 	Überraschung 	Ägypten
NyAshia (Nih-AH-sha) 	schöne afrikanische Prinzessin mit Entschlusskraft 	Nigeria,Ibo
Nyota (ni-o-ta) 	Kriegerin 	Swahili
Nyarai (Nia-rye) 	bescheiden, demütig 	 
Nyela (Ni-ee-lah) 	eine, die erfolgreich und beharrlich ist 	Simbabwe,Shona
NZINGA (n-zing-uh) 	vom Fluss 	Somalia
OBAX (OH-bah)  	Blume  	Somalia
Obioma (O-be-o-ma) 	gutes Herz 	Nigeria,Ibo
Ode 	an der Straße 	Benin
Ogechi 	Gottes Zeit ist die beste Zeit 	Nigeria, Ibo
Ohenewaa 	Königin 	Ghana, Guan oderr Kyereponi
Olabisi  	viel Freude 	Yoruba
Olabunmi  	eine große Ehre wird mir zuteil 	Yoruba
Olaniyi  	Glanz und Reichtum 	Fante
Olayinka 	Ehre umgibt mich 	Nigeria,Yoruba, Sierra Leone,Krio
Olubayo 	höchste Freude 	Yoruba
Oluchi (Oh-lew-chee) 	die Kunst/Werk Gottes 	 
Olufemi 	Gott liebt mich 	Yoruba
Olufunmilayo  	Gott gibt mir Freude 	Yoruba
Oluwa-seyi  (olu-wa-shai-yi)  	Gott hat sie geschaffen 	Nigeria,Yoruba
Oluremi (O-loo-reh-me) 	Gott hat zu  mir gesprochen 	Nigeria,Yoruba
Omolara 	geboren zur rechten Zeit 	Benin
Omorose 	mein wunderschönes Kind 	Benin
Omosede 	ein Kind zählt mehr als ein König 	Benin
Omosupe  	ein Kind die kostbarste Sache 	Benin
ONA 	Feuer 	Westafrika
ONAEDO (oh-nah-ay-DOH) 	Gold 	Nigeria,Ibo
Oni  	geboren an einem heiligen Ort 	 
Ontibile 	Gott passt auf mich auf 	Botswana, Setswan
Onyinyechi (own-yeen-yeh-chee) 	Geschenk Gottes 	Nigeria,Igbo
Osayioniwabo 	Gott hilft uns 	Benin
Oseye 	die Glückliche 	Benin
Ozigbodi  	Geduld, Ausdauer 	Ewe
Paka  	Katze  	Swahili
Pamoja 	zusammen 	Swahili
Panya 	Maus (kleines Baby) 	Swahili
Panyin 	die ältere der Zwillinge 	Ghana,Fante
Penda 	sie ist beliebt 	Senegal,Fula
Pendo 	Liebe 	Swahili
Phenyo (peh-nyoh) 	Sieg 	Botswana,Batswana
Poni 	die Zweitgeborene 	Südsudan,Bari
Pulika 	gehorsam 	Swahili
Qalhata  	Königin der Nubia die Ägypten unter der 25. Dynastie regierte  	 
Qwara 	ein Mensch in Äthiopien der mit einer chushitic Sprache spricht 	Äthiopien
Raawiya  	die Geschichten erzählt  	Swahili
Rabia 	Frühling 	Swahili
Rabuwa 	wachsen 	Swahili
RACHIDA 	rechtschaffen 	Swahili
RADHIYA (rahd-Hee-yah) 	angenehm 	Swahili
RAHA 	Glück 	Kiswahili
Rahima 	energievoll 	Swahili
Rahimu 	Gnade 	Swahili
RAMAKEELE (Rem-ah-key-lay) 	sie kam als Überraschung zu uns 	Südafrika,Sotho
Ramla 	Prophet 	Swahili
Randa 	Tänzerin 	Kiswahili
Ratiba (rat'eba) 	  	Marokko
Rashida 	rechtschaffen 	Virgin Islands
Rayha 	kleine Luxuriöse 	Swahili
Rayyan 	luxuriös 	Swahili
RAZIYA 	süß, angenehm 	Swahili
Rhaxma 	süß 	Somalia
Reem 	weiße Antilope 	Swahili
Rehema 	Mitleid,Erbarmen 	Kiswahili
Rehani 	ein Versprechen 	 
Rukiya (roo-key-ah) 	sie wird hoch aufsteigen 	Swahili
Rusha 	loswerden, abschütteln 	Kiswahili

Saada   	hilfsbereit  	Swahili
Saadiya 	glücklich 	Swahili
Sabiha 	graziös 	Swahili
sabra 	die gGduldige 	Swahili
Sadaka 	eine Gabe 	Swahili
Sadiki 	glaubwürdig 	Swahili
Sadikifu 	vertrauenswürdiger Freund 	Swahili
Sadikika 	vertrauenswürdig 	Swahili
Safaa 	die Reinheit 	Swahili
Safi 	rein 	Swahili
Safisha 	säubern 	Swahili
Safiya  	klares Gewissen, rein 	Swahili
Saida 	die Helferin 	Swahili
Saiha 	gut 	Swahili
Sakina 	ruhig, besonnen 	Swahili
Sala 	ein Gebet 	Swahili
Salama  	Frieden 	 
Samia 	ein Mensch in Uganda 	Uganda
Sankofa 	eine, die zurück aus der Vergangenheit kommen musste, um vorwärts zu kommen 	Ghana,Akan
Sanjo 	eine, die für die Vergangenheit dankbar ist 	Nigeria,Yoruba
Sanyu (sa-niyu) 	Freude oder Glück 	Uganda,Baganda
Saran 	Freude 	Guinea, Elfenbeinküste
Sauda  	dunkle Schönheit 	Swahili
Sayblee (say-blee 	zu Hause sein 	Liberia
Seble (Seb-luh) 	Ernte 	Äthiopien,Amhara
Sela 	gewandt sein 	Westafrika,Ewe
Selam 	Frieden 	Eritrea
Sekai 	Lachen 	Simbabwe
Sema 	zum sprechen 	Kiswahili
Serwa 	die Edle 	Ghana,Ewe
Sesen (se-sen) 	großer Wunsch 	Eritrea
Shakarri 	großer Jäger 	afro-amerikanisch
Shakina 	die Schöne 	 
Shakir (sha-keer 	mit der Gnade Gottes geboren 	Nigeria
Shani 	wundervoll 	Swahili
Sharifa 	die Berühmte 	Swahili
Shartati (Sha-tah-ree) 	der schönste berg 	Äthiopien
Shateque (Sha-tee-kwa 	Schülerin 	afro-amerikanisch
Shaquana (Sha-kwan-a) 	Wahrhaftigkeit im Leben 	afro-amerikanisch
Sheba 	Königin von Sheba 	 
Shema (Shay-mah) 	ein Mensch, der still, ruhig und zurückhaltend ist 	Ruanda,Tutsi
Shoorai 	ein Besen der kehrt 	Simbabwe,Shona
Shukura  	ich bin großartig 	 
Sikudhani  	eine schöne Überraschung 	 
Sisi (see see) 	geboren am Sonntag 	Nigeria,Twi
Siyanda (See-yah -ndah) 	wir wachsen 	Südafrika,Zulu
Sushaunna (su-sha-na) 	Prinzessin/Göttin der Männer 	Äthiopien
Taariq (Tah-reek)  	Morgenstern  	Swahili
Tabita 	graziös 	Swahili
Tafida 	Nutzen 	Swahili
Tafui 	der Ruhm Gottes 	Togo,Mina
Tahira 	sauber, rein 	Swahili
Tahiya 	Wachsamkeit, wachsam 	Swahili
Taja 	erwähnen 	Kiswahili
Takiyah 	rechtschaffen 	 
Tale 	grün 	Tswana
Talha 	leichtes Leben 	Swahili
Tamaa 	Verlangen 	Swahili
Tamasha 	glückliche Begebenheit 	Swahili
Tambika 	Gabe, Opfer 	Swahili
Tambuzi 	intelligent 	Swahili
Tamu 	süß 	Swahili
Tanabahi 	vorsichtig sein 	Swahili
Tanginika (Tann-J-Nee-ka) 	der See Gottes 	afro-amerikanisch
Tanisha 	geboren am Montag 	Nigeria,Hausa
Tangela (tang-a-la) 	eine Schützende 	afro-amerikanisch
Tangeni (ta-nge-ni) 	bete zu Gott 	Namibia,Owambo
Tapiwa 	Geschenk 	Simbabwe,Shona
Taraji 	Hoffnung, Glaube 	Swahili
Tarajika 	Hoffnung, Glaube 	Swahili
Tarana 	am Tag geboren 	Nigeria,Hausa
Tarisai (Tari-sayi) 	schau auf sie 	Simbabwe
Tata 	Wirrwarr 	Kiswahili
Tathinina 	sehr wertvoll 	Swahili
Tatu  	die Drittgeborene 	Swahili
Tawiah 	das erste Kind nach Zwillingen 	Ghana,Ga
Tendai (ten-dhai) 	sei Gott dankbar 	Simbabwe,Shona
Terehasa (Ta-ra-Ha-sa) 	gesegnet 	Äthiopien
Thandiwe  	sie wird geliebt 	 
Thema  	Königin 	 
Tiombe (Tee-ohm-bay) 	glänzend, strahlend 	Westafrika
Titilayo (tee-tee-lye-oh) 	das Glück ist ewig 	Nigeria,Yoruba
Tumpe  	lass uns Gott danken 	 
Tuwalole  	beispielhaft 	 
Tusajigwe  	wir sind gesegnet 	 
Tsehai 	Sonnenschein 	Äthiopien
Tshepiso 	Versprechen, Hoffnung 	Südafrika,Tswana
Ubekwenisha (Ooo-bek-kwen-eesha)  	Mutter der Rechtschaffenen  	Nigeria,Yoruba
Uboro 	ausgezeichnet, vortrefflich 	Kiswahili
Uchefuna 	ich habe meinen Humor bei mir 	Ibo
Uchenna 	Gottes Wille 	Nigeria,Ibo
Udako 	Respekt 	Namibia
Udama (U'da'ma) 	schöne Blume 	Algerien
Ugochi (Ooh-go-chi) 	Gottes Geschenk 	Nigeria
Uheri 	gutes Glück 	Swahili
Uhuru 	Freiheit 	Kiswahili
Ujamaa 	die Familie 	Swahili
Ukarimu 	Gastfreundlichkeit 	Swahili
Ulu 	die Zweitgeborene 	Nigeria,Ibo
Unguja 	Zanzibar 	Swahili
Urbi  	Prinzessin 	Benin
Urenna 	Vaters Stolz 	 
Uwimana  	Tochter Gottes 	Tswana
Uzima 	energievoll, gesund 	Swahili
Uzuri 	die Schöne 	Swahili

Vana  	Erfüllung  	Kongo
Vai  	ein Mensch in Sierra Leone 	 
Vasha  	Sprache in Südafrika 	 
Venda 	Bantu in Südafrika 	
Waceera  	sie wandert  	Kikuyu
Wairimu 	eine von den 9 Gründern der Agikuyu Leute 	Kikuyu
Waitherero 	von dem Flusses Strom 	Kikuyu
Wakiuru 	eine von den 9 Gründern der Agikuyu Leute 	Kikuyu
Wambui  	Sängerin 	Kenia, Kikuyu
Wamuiru 	schwarzhäutige Schönheit 	Kikuyu
Wamweru 	hellhäutige 	Kikuyu
Wangai 	durch Gott geboren 	Kikuyu
Wangari 	Leopard 	Kikuyu
Wangera 	eine Reisende 	Kikuyu
Wanjiko (Wahn-jee-koh) 	  	Kenia, Kikuyu
Walasma 	Name einer Königsfamilie, die in Ostäthiopien regierte 	Äthiopien
Wanda 	wird dick 	Kiswahili
Wub 	prächtig, schön 	Äthiopien
Xetsa (heht-sah)  	Name, der einem Zwilling gegeben wird  	Ghana,Ewe
